############################
#............##............#
#.####.#####.##.#####.####.#
#.####.#####.##.#####.####.#
#.####.#####.##.#####.####.#
#..........................#
#.####.##.########.##.####.#
#.####.##.########.##.####.#
#......##....##....##......#
######.#####.##.#####.######
     #.#####.##.#####.#     
     #.##..........##.#     
     #.##.########.##.#     
######.##.#      #.##.######
..........#      #..........
######.##.#      #.##.######
     #.##.########.##.#     
     #.##..........##.#     
     #.##.########.##.#     
######.##.########.##.######
#............##............#
#.####.#####.##.#####.####.#
#.####.#####.##.#####.####.#
#...##................##...#
###.##.##.########.##.##.###
###.##.##.########.##.##.###
#......##....##....##......#
#.##########.##.##########.#
#..........................#
############################
